
xxxxxxxxxxxxxxxx
x               x
xxxxxxxxxxxxxv x
x    vvv     v x
x     v        x
x      v      x x
xssssssssssssssx
xv  v   v   v xx
x             xx
x      x s xxxxx
x       x v   fx
xxxxxxxxxxxxxxxx
